NO ./file.cub
SO ./file.cub
WE ./file.cub
EA ./file.cub
F 220,100,0
C 25, 30, 0

11111111111111111111111111
10000000000000000011000011
1000000E000000000010000001
10000000000011101100000001
1000000001110 100000001011
10000000110011100011000011
10100100000011000010000001
10100100000011001100000001
10000000011110000000001011
11111111111111111111111111
