NO ./file.cub
SO ./file.cub
WE ./file.cub
EA ./file.cub
F 220,100,0
C 25, 30, 0

1111111111111
1000000011001
1010010S00001
1010010000001
1000000001111
11111111111
