
 	 	 	 NO includes/textures/wolfenstein/blue_stone.xpm	 	 	 		 		 	 	
SO includes/textures/wolfenstein/color_stone.xpm
WE includes/textures/wolfenstein/grey_stone.xpm
EA includes/textures/wolfenstein/mossy.xpm


	 	 	 C			 0		 ,		 100		 ,		 150	 		


			F	30 	, 	30 	, 	30 	 	 	


DO 		includes/textures/Wall_door.xpm





1111111111111111111111111111
1000000000000000000000000001
1000000000010000000000000001
10000000001 1000000000000001
1000000000010000000000000001
1000000000000000000000000001
10000000000N0000000000000001
1000000000000000000000000001
1000000000000000000111111111
1000000000000000000D00000001
1111111111111111111111111111
