				 NO		    ./Wall_pompier.xpm

SO            									./Wall_classic.xpm


      C 			0, 100 , 150


			F      30,30,30

			EA   			./Wall_window.xpm

WE    			./Wall_windowx2.xpm




  1111111111111111
  10000000000000001
1110010111111100001
1001100111 11000001
1001000000100000011
1000W0000000001001
100010000111111001
100101000000010001
100010000000100001
100000000000000001
111111111111111111
