				 NO              ./Wall_pompier.xpm     
SO            									./Wall_classic.xpm
					 

			C 			0,100,150    	
		

			F      30,30,30		
			
			EA   			./Wall_window.xpm

WE    			./Wall_windowx2.xpm

		 


  1111111111111111
  10000000000000001
1110000111111100001
1001000111 11000001
1001000000100000011
1001N0000000001001
100111000111111001
100000000000000001
100000000000000001
100000000000000001
100000000000000001
100000000100000001
100000001 100000001
100000000100000001
100000000000000001
100000000000000001111111111111111111111111111111111111111111111111111111111111111111111111111111
100000000000000000000000000000000000000000000000000000000000000000000000000000000000000000000001
100000000000000001111111111111111111111111111111111111111111111111111111111111111111111111111111
111111111111111111