
NO includes/textures/wolfenstein/blue_stone.xpm
SO includes/textures/wolfenstein/color_stone.xpm
WE includes/textures/wolfenstein/grey_stone.xpm
EA includes/textures/wolfenstein/mossy.xpm


C 	0  ,100,150


			F      30,30,30


DO 		includes/textures/Wall_door.xpm





  11111111111111111111111111111111111111
  100000000000000000000000000000000000001
11100001111111000000000000000000000000001
1001000111 110000000000000000000000000001
10010000001000000111111111111D11111111111
1001N0000000001001          1000000001
100111000111111001          1000000001
10000000000000001          1000000001
100000000000000001          1000000001
100000000000000001          1000000001
100000000000000001          1000000001
100000000100000001          1000000001
100000001 100000001         1000000001
100000000100000001          1000000001
100000000000000001          1000000001
10000000D00000000111111111111000000001
10000000000000000D00000000000000000001
10000000000000000111111111111111111111
111111111111111100000000000000001
111111111111111111111111111111111
